State,Under 5 Years,5 to 13 Years,14 to 17 Years,18 to 24 Years,25 to 44 Years,45 to 64 Years,65 Years and Over,total
AL,310504,552339,259034,450818,1231572,1215966,641667,4661900
AK,52083,85640,42153,74257,198724,183159,50277,686293
AZ,515910,828669,362642,601943,1804762,1523681,862573,6500180
AR,202070,343207,157204,264160,754420,727124,407205,2855390
CA,2704659,4499890,2159981,3853788,10604510,8819342,4114496,36756666
CO,358280,587154,261701,466194,1464939,1290094,511094,4939456
CT,211637,403658,196918,325110,916955,968967,478007,3501252
DE,59319,99496,47414,84464,230183,230528,121688,873092
DC,36352,50439,25225,75569,193557,140043,70648,591833
FL,1140516,1938695,925060,1607297,4782119,4746856,3187797,18328340
GA,740521,1250460,557860,919876,2846985,2389018,981024,9685744
HI,87207,134025,64011,124834,356237,331817,190067,1288198
ID,121746,201192,89702,147606,406247,375173,182150,1523816
IL,894368,1558919,725973,1311479,3596343,3239173,1575308,12901563
IN,443089,780199,361393,605863,1724528,1647881,813839,6376792
IA,201321,345409,165883,306398,750505,788485,444554,3002555
KS,202529,342134,155822,293114,728166,713663,366706,2802134
KY,284601,493536,229927,381394,1179637,1134283,565867,4269245
LA,310716,542341,254916,471275,1162463,1128771,540314,4410796
ME,71459,133656,69752,112682,331809,397911,199187,1316456
MD,371787,651923,316873,543470,1556225,1513754,679565,5633597
MA,383568,701752,341713,665879,1782449,1751508,871098,6497967
MI,625526,1179503,585169,974480,2628322,2706100,1304322,10003422
MN,358471,606802,289371,507289,1416063,1391878,650519,5220393
MS,220813,371502,174405,305964,764203,730133,371598,2938618
MO,399450,690476,331543,560463,1569626,1554812,805235,5911605
MT,61114,106088,53156,95232,236297,278241,137312,967440
NE,132092,215265,99638,186657,457177,451756,240847,1783432
NV,199175,325650,142976,212379,769913,653357,296717,2600167
NH,75297,144235,73826,119114,345109,388250,169978,1315809
NJ,557421,1011656,478505,769321,2379649,2335168,1150941,8682661
NM,148323,241326,112801,203097,517154,501604,260051,1984356
NY,1208495,2141490,1058031,1999120,5355235,5120254,2607672,19490297
NC,652823,1097890,492964,883397,2575603,2380685,1139052,9222414
ND,41896,67358,33794,82629,154913,166615,94276,641481
OH,743750,1340492,646135,1081734,3019147,3083815,1570837,11485910
OK,266547,438926,200562,369916,957085,918688,490637,3642361
OR,243483,424167,199925,338162,1044056,1036269,503998,3790060
PA,737462,1345341,679201,1203944,3157759,3414001,1910571,12448279
RI,60934,111408,56198,114502,277779,282321,147646,1050788
SC,303024,517803,245400,438147,1193112,1186019,596295,4479800
SD,58566,94438,45305,82869,196738,210178,116100,804194
TN,416334,725948,336312,550612,1719433,1646623,819626,6214888
TX,2027307,3277946,1420518,2454721,7017731,5656528,2472223,24326974
UT,268916,413034,167685,329585,772024,538978,246202,2736424
VT,32635,62538,33757,61679,155419,188593,86649,621270
VA,522672,887525,413004,768475,2203286,2033550,940577,7769089
WA,433119,750274,357782,610378,1850983,1762811,783877,6549224
WV,105435,189649,91074,157989,470749,514505,285067,1814468
WI,362277,640286,311849,553914,1487457,1522038,750146,5627967
WY,38253,60890,29314,53980,137338,147279,65614,532668